行動を代わる	に を	人間に 知的行動を
処理を用いる	を	記号処理を
記述をする	と を	主体と 記述を
注目を集める	が を	「サポートベクターマシン」が 注目を
経験を行う	に を	元に 学習を
学習を行う	に を	元に 学習を
流行を超える	を	流行を
学習を繰り返す	を	学習を
進化を見せる	て において は を	加えて、 生成技術において （敵対的生成ネットワーク）は、 進化を
生成を行う	を	コンテンツ生成を
開発を行う	は を	エイダ・ラブレスは 開発を
処理を行う	を	処理を
処理を行う	に により を	Webに ティム・バーナーズ＝リーにより、 知的処理を
処理を行う	て に を	付加して、 コンピュータに 知的処理を
研究を進める	て を	費やして 研究を
注目を集める	から は を	ことから、 ファジィは 注目を
成功を受ける	を	成功を
制御を用いる	て も を	受けて、 他社も 知的制御を
進歩を担う	を	進歩を
改善を果たす	が で に を	チームが 画像処理コンテストで 2012年に 精度改善を
プログラムを使う	を	専用プログラムを
研究を続ける	が て を	ジェフ・ホーキンスが、 向けて 研究を
注目を集める	に を	急速に 注目を
普及を受ける	を	普及を
学習を組み合わせる	を	機械学習を
投資を行う	で に を	民間企業主導で 全世界的に 投資を
探索を行う	で を	無報酬で 探索を
研究を始める	とも は を	マックスプランク研究所とも Googleは、 共同研究を
研究を行う	て を	始めており、 研究を
実験をする	を	実験を
投資をする	に は を	2022年までに 韓国は、 投資を
シミュレーションを行う	を	脳シミュレーションを
反乱を起こす	て に対して を	於いて、 人間に対して 反乱を
弾圧を併せ持つ	を	弾圧を
監視を行う	に まで を	人工知能に 歩行者まで 監視を
手続きを経る	を	法的手続きを
差別を認める	を	差別を
展開を変える	を	展開を
判断を介す	から を	観点から 判断を
禁止を求める	が は を	ヒューマン・ライツ・ウォッチが、 4月には 禁止を
運用をめぐる	を	運用を
競争を行う	は を をめぐって	米国・中国・ロシアは 開発競争を 軍事利用をめぐって
試験を行う	を	試験を
追及を受ける	て で と とともに は を	暴露されており、 整合性で 拒否すると 「」とともに、 公聴会では、 追及を
存在を見いだす	に を	ものに 霊的存在を
話をする	は を	哲学者は 話を
疎通を行う	を	意思疎通を
勘違いをする	を	勘違いを
議論を行う	まで を	「これまで 議論を
